3  3  3  3  3  3  3  3  3  
3  0  0  0  0  7  0  0  3
3  0  3  0  0  0  0  0  3
3  0  0  0  0  0  0  0  3
3  0  3  0  0  0  0  0  3
3  0  0  0  0  0  0  7  3
3  0  0  0  0  0  0  0  3
3  0  3  0  0  0  7  7  3
3  3  3  3  3  3  3  3  3