3  3  3  3  3  3  3  3  3  3  3  3  3  3  3  3  3  3  3  3  3  3
3  1  0  0  0  3  0  7  0  3  7  0  0  0  0  7  0  7  0  7  0  3
3  0  0  0  0  0  7  0  0  0  0  7  0  7  0  3  0  3  0  0  0  3
3  3  0  7  0  7  0  3  0  0  3  3  0  7  0  7  0  0  0  7  7  3
3  0  7  3  0  7  3  0  0  3  0  3  0  3  3  0  0  0  0  0  0  3
3  0  0  0  3  3  0  0  7  0  7  0  7  0  0  3  0  7  0  3  0  3
3  7  0  0  0  0  3  0  0  7  3  3  0  3  0  0  0  3  0  3  0  3
3  0  0  0  0  3  0  0  0  3  0  0  7  7  7  0  0  0  0  0  7  3
3  0  0  0  7  0  0  3  0  0  7  3  0  3  0  0  7  0  0  7  3  3
3  0  3  7  0  3  0  7  0  7  0  0  7  0  7  7  0  0  0  3  0  3
3  0  7  3  0  0  7  0  0  0  7  3  0  3  0  0  3  0  3  7  0  3
3  7  0  0  0  7  0  3  7  0  0  0  3  0  3  0  7  0  0  3  7  3
3  0  7  3  3  0  7  0  3  0  0  7  0  0  0  0  0  3  7  0  0  3
3  7  0  0  0  0  7  0  0  0  7  0  3  0  0  0  3  0  0  0  7  3
3  0  0  7  0  0  0  0  3  0  0  0  3  7  0  3  0  7  0  0  0  3
3  7  3  0  3  0  0  3  0  0  3  0  0  3  3  0  7  0  0  0  0  3
3  0  0  0  0  0  7  3  7  0  0  0  0  0  7  0  3  7  0  3  0  3
3  3  3  3  3  3  3  3  3  3  3  3  3  3  3  3  3  3  3  3  3  3